0010222255331111
0010222255331111
0011000055331111
0001110055331111
2200010055331111
2220010055331111
2220010055331111