0010222255
0010222255
0011000055
0001110055
2200010055
2220010055
2220010055